99999999999999999999999999999999999999999999999999999999999999
92111111111111111111111111111111111111111111111111111111111129
91000000000000000000000000000000000000000000000000000000000019
91000000000000000000000000000000000000000000000000000000000019
91000000000000000000000000000000000000000000000000000000000019
91000000000000000000000000000000000000000000000000000000000019
91000000000000000000000000000000000000000000000000000000000019
91000000000000000000000000000000000000000000000000000000000019
91000000000000000000000000000000000000000000000000000000000019
91000000000000000000111111111111111111111000000000000000000019
91000000000000000000000000000010000000000000000000000000000019
91000000000000000000000000000010000000000000000000000000000019
91000000000000000000000000000010000000000000000000000000000019
91000000000000000000000000000010000000000000000000000000000019
91000000000000000000000000000010000000000000000000000000000019
91000000000000000000111111111121111111111000000000000000000019
91000000000000000000000000000010000000000000000000000000000019
91000000000000000000000000000010000000000000000000000000000019
91000000000000000000000000000010000000000000000000000000000019
91000000000000000000000000000010000000000000000000000000000019
91000000000000000000000000000010000000000000000000000000000019
91000000000000000000111111111111111111111000000000000000000019
91000000000000000000000000000000000000000000000000000000000019
91000000000000000000000000000000000000000000000000000000000019
91000000000000000000000000000000000000000000000000000000000019
91000000000000000000000000000000000000000000000000000000000019
91000000000000000000000000000000000000000000000000000000000019
91000000000000000000000000000000000000000000000000000000000019
91000000000000000000000000000000000000000000000000000000000019
91000000000000000000000000000000000000000000000000000000000019
92111111111111111111111111111111111111111111111111111111111129
99999999999999999999999999999999999999999999999999999999999999